120 5 3 0
Sa. .b.b.
a a b b b
.a.a.a.a.
b b   b a
.b.b.bDa.